00000000000000000000000000000000000000000000000
00000000000000000000000000000000000000000000000
00000000000000000000000000000000000000000000000
00000000000000000000000000000000000000000000000
00000000000000000000000000000000000000000000000
00000000000000000000000000000000000000000000000
00000000000000000000000000000000000000000000000
00000000000000000000000000000000000000000000000
00000000000000000000000000000000000000000000000
00000000000000000000000000000000000000000000000
00000002222200000000000000000000000000000000000
00000000000000000000000000000000000000000000000
22000000000000000000000002200000000002222000000
11222222222222222000000221120000000001111200000
11111111111111111200000111110000000000111100000
11111111111111111120000011000000000000011000000
111111111111111111120000000000000000000000000
11111111111111111111200000000000000000000000000
11111111111111111111122222222222222222222222222
11111111111111111111111111111111111111111111111
11111111111111111111111111111111111111111111111
11111111111111111111111111111111111111111111111

